ナルト=Naruto
サスケ=Sasuke
サクラ=Sakura
シカマル=Shikamaru
チョウジ=Choji
キバ=Kiba
ネジ=Neji
リー=Lee
ガアラ=Gaara
テマリ=Temari
カンクロウ=Kankuro
じらいや=Jiraiya
ツナデ=Tsunade
オロチまる=Orochimaru
カカシ=Kakashi
いの=Ino #leave space
シノ=Shino
ヒナタ=Hinata
テンテン=Tenten
イタチ=Itachi
キサメ=Kisame
カブト=Kabuto
ジロウボウ=Jirobo
キドウマル=Kidomaru
タユヤ=Tayuya
サコン=Sakon
キミマロ=Kimimaro
ガイ=Guy
アスマ=Asuma
くれない=Kurenai
シズネ=Shizune
あかまる=Akamaru
イビキ=Ibiki
アンコ=Anko
イルカ=Iruka
このはまる=Konohamaru
エビス=Ebisu
テウチ=Teuchi
ミズキ=Mizuki
タズナ=Tazuna
イナリ=Inari
ホムラ=Homura
コハル=Koharu
トントン=Tonton
パックン=Pakkun
ガマきち=Gamakichi
ガマたつ=Gamatatsu
カツユ=Katsuyu
ゾウリ=Zori
ワラジ=Waraji
？？？=???
ブンた=Gamabunta
マンダ=Manda
