ひょうろうがん=Food Pills
いりょう班の兵糧丸=Medical Food Pills
ガマ印の兵糧丸=Toad Brand Food Pills
ちょうぜつ印の兵糧丸=Super Brand Food Pills
チャクラ丸=Chakra Pills
いりょう班のチャクラ丸=Medical Chakra Pills
ガマ印のチャクラ丸=Toad Brand Food Chakra Pills
ちょうぜつ印のチャクラ丸=Super Brand Chakra Pills
万能丸（ばんのうがん）=Versatile Pills
ちょうぜつ印の万能丸=Super Brand Versatile Pills
きょうそう丸=Competition Pills
こうてつ丸=Steel Pills
しっぷう丸=Wind Pills
瞬身（しゅんしん）の巻物=Escape Scroll
変わり身の巻物=Substitution Scroll
火とんの巻物=Fire Style Scroll
水とんの巻物=Water Style Scroll
雷とんの巻物=Lightning Style Scroll
風とんの巻物=Wind Style Scroll
石=Stone
きばく札（ふだ）=Explosive Paper
強力きばく札=Super Explosive Paper
暗部のきばく札=Anbu Paper Bomb
けむり玉=Smoke Bomb
毒（どく）けむり玉=Poison Smoke Bomb
まきびし=Makibishi Spikes
さくらん香=Confusion Aroma
ふういん玉=Seal Ball
よわき玉=Timid Ball
なんじゃく玉=Wimp Ball
ねんちゃく玉=Sticky Ball
ガマ寄せの巻物=Summon Toad Scroll
九尾寄せの巻物=Summon Nine-Tailed Fox Scroll
カップラーメン=Cup Ramen
秘伝のきずぐすり=Family Secret Ointment
あまぐり=Sweet Chestnuts
スーパーあまぐり=Jumbo Sweet Chestnuts
毒（どく）マニュアル=Poison Manual
金しばりマニュアル=Immobility Manual
さくらんマニュアル=Confusion Manual
くらやみマニュアル=Blindness Manual
術ふうじマニュアル=Sealed Jutsu Manual
よろずマニュアル=General Manual
こうげきカンポウ丸=Attack Chinese Medicine Pills
ぼうぎょカンポウ丸=Defense Chinese Medicine Pills
すばやさカンポウ丸=Agility Chinese Medicine Pills
にんりょくカンポウ丸=Ninja Power Chinese Medicine Pills
スタミナカンポウ丸=Stamina Chinese Medicine Pills
チャクラカンポウ丸=Chakra Chinese Medicine Pills
イチャイチャパラダイス=Make-Out Paradise
イチャイチャバイオレンス=Make-Out Violence
イチャイチャライセンス=Make-Out License
リストバンド=
バラのはなたば=
てかがみ=
てぬぐい=
おかしのつめあわせ=
ほね=
虫かご=
ぶき大ぜんしゅう=
ＨＡＰＰＹ　ゴーグル=
サングラス=
ガイのブロマイド=Guy Bromide
暗部のおめんストラップ=
ガマちゃんサイフ=
ガマ吉ハッピ=
ガマ竜のオヤツぶくろ=
トントンのしんじゅ=
パックンキーホルダー=
わりびきけん=Coupon
かくれみの=Magic Cloak
忍ぶえ=Ninja Whistle
ろうやのかぎ=
かいふう札・臨（りん）=Seal Release Tag: Rin
かいふう札・兵（ひょう）=Seal Release Tag: Hyo
かいふう札・闘（とう）=Seal Release Tag: Tou
ちぎれた巻物１=Torn Scroll 1
ちぎれた巻物２=Torn Scroll 2
ちぎれた巻物３=Torn Scroll 3
ちぎれた巻物４=Torn Scroll 4
ちぎれた巻物５=Torn Scroll 5
ひじゅつの巻物=Secret Jutsu Scroll
きんじゅつの巻物=Forbidden Jutsu Scroll
パックン口よせ巻物=Pakkun's Summoning Scroll
サスケのおもいで=
ガアラの忍しきふだ=Gaara's Ninja Tag
テマリの忍しきふだ=Temari's Ninja Tag
カンクロウの忍しきふだ=Kankuro's Ninja Tag
じらいやの忍しきふだ=Jiraiya's Ninja Tag
ツナデの忍しきふだ=Tsunade's Ninja Tag
オロチまるの忍しきふだ=Orochimaru's Ninja Tag
カカシの忍しきふだ=Kakashi's Ninja Tag
いのの忍しきふだ=Ino's Ninja Tag
シノの忍しきふだ=Shino's Ninja Tag
ヒナタの忍しきふだ=Hinata's Ninja Tag
テンテンの忍しきふだ=Tenten's Ninja Tag
イタチの忍しきふだ=Itachi's Ninja Tag
綱手のしゃしん=Tsunade's Photo
綱手のくびかざり=Tsunade's Necklace
ナルトの入よくけん=Naruto's Bath Ticket
サスケの入よくけん=Sasuke's Bath Ticket
サクラの入よくけん=Sakura's Bath Ticket
シカマルの入よくけん=Shikamaru's Bath Ticket
チョウジの入よくけん=Choji's Bath Ticket
キバの入よくけん=Kiba's Bath Ticket
ネジの入よくけん=Neji's Bath Ticket
リーの入よくけん=Lee's Bath Ticket
ガアラの入よくけん=Gaara's Bath Ticket
テマリの入よくけん=Temari's Bath Ticket
カンクロウの入よくけん=Kankuro's Bath Ticket
じらいやの入よくけん=Jiraiya's Bath Ticket
ツナデの入よくけん=Tsunade's Bath Ticket
オロチまるの入よくけん=Orochimaru's Bath Ticket
カカシの入よくけん=Kakashi's Bath Ticket
いのの入よくけん=Ino's Bath Ticket
シノの入よくけん=Shino's Bath Ticket
ヒナタの入よくけん=Hinata's Bath Ticket
テンテンの入よくけん=Tenten's Bath Ticket
イタチの入よくけん=Itachi's Bath Ticket
ガイの入よくけん=Guy's Bath Ticket
アスマの入よくけん=Asuma's Bath Ticket
シズネの入よくけん=Shizune's Bath Ticket
くれないの入よくけん=Kurenai's Bath Ticket
イルカの入よくけん=Iruka's Bath Ticket
このはまるの入よくけん=Konohamaru's Bath Ticket
エビスの入よくけん=Ebisu's Bath Ticket
アンコの入よくけん=Anko's Bath Ticket
ブンたの入よくけん=Gamabunta's Bath Ticket
マンダの入よくけん=Manda's Bath Ticket
カツユの入よくけん=Katsuyu's Bath Ticket
赤丸の入よくけん=Akamaru's Bath Ticket
トントンの入よくけん=Tonton's Bath Ticket
パックンの入よくけん=Pakkun's Bath Ticket
ガマ吉の入よくけん=Gamakichi's Bath Ticket
ガマ竜の入よくけん=Gamatatsu's Bath Ticket
木ノ葉ひとう１００せん=100 Hotsprings to Visit Before You Die
しのびばな・ハナシノブ=
木ノ葉ひでん忍術ずかん=
三忍のちょうせんじょう=Challenge of the Sannin
うちはのきろく=Memory of the Uchiha
火とんの術・壱の巻=
火とんの術・弐の巻=
火とんの術・参の巻=
水とんの術・壱の巻=
水とんの術・弐の巻=
水とんの術・参の巻=
雷とんの術・壱の巻=
雷とんの術・弐の巻=
雷とんの術・参の巻=
風とんの術・壱の巻=
風とんの術・弐の巻=
風とんの術・参の巻=
木刀=Hexagonal Stick
こだち=Small Sword
忍刀=Ninja Sword
サクラふぶき=Cherry Blossom Storm
ひめつる一文字=Himetsuru Swift Sword
えんげつ刀=Round Moon Sword
むらまさ=Muramasa
わ刀=Samurai Sword
三忍の忍刀=Sannin's Ninja Sword
ムラサメ=Murasame
あまのはばおり=Dragon Slayer
ふつのみたま=Departed Soul of Futsu
火影の忍刀=Hokage Ninja Sword
雷神の剣=Raijin Sword
ガマのドス=Toad Blade
四代目の忍刀=4th Hokage's Sword
せんす=Fan
てっせん=Battle Fan
にんぷうせん=Ninja Wind Fan
てんせん=Heaven Fan
きょうてんせん=Super Heaven Fan
龍りんせん=Dragon Fan
三忍のせんす=Sannin's Fan
風神のせんす=Fujin Fan
アラレだま=Arare Pellets
ぼう手裏剣=Rod Shuriken
手裏剣=Shuriken
六方手裏剣=Six-Edged Shuriken
八方手裏剣=Eight-Edged Shuriken
三忍の手裏剣=Sannin’s Shuriken
龍りん手裏剣=Dragon Shuriken
八光手裏剣=Hakko Shuriken
火影の手裏剣=Hokage Shuriken
うちこみ丸カン=Steel Ring
クナイ=Kunai
両刃クナイ=Double-Edged Kunai
ダブルブレード=Double Blade
三忍のクナイ=Sannin's Kunai Knife
火影のクナイ=Hokage Knife
五寸くぎ=Large Nail
千本=Senbon
羽針=Winged Nail
三忍の千本=Sannin's Senbon
火影の千本=Hokage Senbon
アイアンナックル=Iron Knuckle
かぎ爪=Hooked Claw
たかの爪=Falcon Claw
虎の爪=Tiger Claw
三忍の爪=Sannin's Claw
りゅうの爪=Dragon Claw
九尾の爪=Nine-Tailed Claw
鉄くさり=
忍ガマ=
くさり笛=Chained Whistle
くさりエナシ=Ball and Chain
三忍のくさりガマ=Sannin's Chained Sickle
木ノ葉のこんぼう=Leaf Village Staff
門ばんのぼう=Gatekeeper Staff
トンファー=Tonfa
ヌンチャク=Nunchuk
三せつこん=Triple Segmented Staff
はちりょうすい=Hachiryousui
こんごうぼう=Adamantine Staff
しゅかくの砂=
かわのベスト=Leather Vest
木ノ葉のかたびら=Leaf Chain Mail
くさりかたびら=Chain Mail
金らんの胴丸=Gold Armor
合金のベスト=Alloy Vest
ふうまかたびら=Fan-like Chain Mail
しゅらの胴丸=Asura Armor
宝玉のベスト=
強天の胴丸=Super Heaven Armor
明光のベスト=Meikou Vest
龍りんかたびら=Dragon Chain Mail
あんぶのベスト=Anbu Vest
呪印のベスト=Cursed Mark Vest
こんごうのベスト=Adamantine Vest
三忍のベスト=Sannin Vest
火影のかたびら=Hokage Armor
九尾のかたびら=Nine-Tailed Fox Mail
四代目のマント=Hokage Mantle
かわの脚絆=Leather Pants
木ノ葉の脚絆=Hidden Leaf Pants
鉄ビョウの脚絆=Spiked Pants
金らんの脚絆=Gold Pants
ふうまの脚絆=Fan-like Pants
しゅらの脚絆=Asura Pants
宝玉の脚絆=
はやぶさの脚絆=
げっこうの脚絆=Moonlight Pants
ひえんの脚絆=Hien Pants
しでんの脚絆=Shiden Pants
強天の脚絆=Super Heaven Pants
龍りんの脚絆=Dragon Pants
火影の脚絆=Hokage Pants
呪印の脚絆=Cursed Mark Pants
九尾の脚絆=Nine-Tailed Fox Spirit Pants
影ぶようの脚絆=Dancing Leaf Pants
いだてんの脚絆=Idaten Pants
じんそくの脚絆=Jinsoku Pants
そうびなし=None
モンスター専用１=
モンスター専用２=
モンスター専用３=
モンスター専用４=
モンスター専用５=
モンスター専用６=
モンスター専用７=
モンスター専用８=
モンスター専用９=
モンスター専用１０=
