火とんの術・壱の巻=
火とんの術=Fire Style Jutsu: Level 1
火とんの術・弐の巻=
大火とんの術=Fire Style Jutsu: Level 2
じゅうじん火えんほうしゃ=Man Beast Flameshot
火とんの術・参の巻=
ちょう大火とんの術=Fire Style Jutsu: Level 3
じゅうじん火えん連しゃ=Man Beast Flameburst
水とんの術・壱の巻=
水とんの術=Water Style Jutsu: Level 1
水ふうせんばくだん=Water Balloon
ちょくげきマーキング=
水とんの術・弐の巻=
大水とんの術=Water Style Jutsu: Level 2
うずまき水りゅう=
３かいてんひねり=
水とんの術・参の巻=
ちょう大水とんの術=Water Style Jutsu: Level 3
雷とんの術・壱の巻=
雷とんの術=Lightning Style Jutsu: Level 1
雷とんの術・弐の巻=
大雷とんの術=Lightning Style Jutsu: Level 2
雷とんの術・参の巻=
ちょう大雷とんの術=Lightning Style Jutsu: Level 3
風とんの術・壱の巻=
風とんの術=Wind Style Jutsu: Level 1
くぐつとっぷう=Puppet Wind Blast
風とんの術・弐の巻=
大風とんの術=Wind Style Jutsu: Level 2
風とんの術・参の巻=
風とん・大とっぱ=Wind Style: Devastation
春いちばんの術=First Spring Jutsu
おうきゅう手あて=Emergency Treatment
やせがまん=
赤丸キズなめ=Akamaru's Wound Lick
手あて=First Aid
こんじょう=Guts
ちりょう=Healing
ちゆ=Wide Healing
ガマのあぶらちゆ=Toad Healing Oil
みょうしゅふっかつ・臨=Mobility Heal: Rin
みょうしゅふっかつ・兵=Mobility Heal: Hyo
解・どく=Release: Poison
クナイどくぬき=Kunai Poison Letting
げどく蟲=Antidote Insects
解・くらやみ=Release: Blindness
解・術ふうじ=Release: Sealed Jutsu
解・よろず=Release: General
木ノ葉のたて=Hidden Leaf Shield
ナイスガイのポーズ=Nice Guy Pose
扇ぼうぎょ=Fan Defense
ガマの小手=Toad Fist
おうえんの術=Cheering Jutsu
とうこんちゅうにゅう=Fighting Spirit Injection
ガルＢポテート=Choritos Chips
赤丸のゆうき=Akamaru's Bravery
ハリセンしった=Fan Telling Off
がんばりなっ！！=Hang in there!
ボッコボコよー！！=Beat 'Em Black and Blue!
が・・・がんばって！=H-Hang in there!
しっかりしなさいよー！=Pull yourself together!
くらやみの術=Blindness Jutsu
はるかすみの術=Spring Haze Jutsu
かげつつみの術=Shadow Bubble Jutsu
やみよせの術=
くぐつえんまく=Puppet Smoke Screen
ガマのなめまわし=Toad Lick
蟲つつみの術=Insect Wrap Jutsu
こもりうたの術=Lullaby Jutsu
ヒツジぐもの術=Sheep Cloud Jutsu
くぐつねむりこう=Puppet Sleeping Powder
ガマのがっしょう=Toad Chorus
ねはんしょうじゃの術=Feather Illusion Jutsu
変わり身の術=Substitution Jutsu
しゅんしんの術=Escape Jutsu
オナラ=Fart
おいろけの術=Sexy Jutsu
ハーレムの術=Harem Jutsu
かげ分身の術=Shadow Clone Jutsu
うずまきナルト連弾=Naruto Uzumaki Barrage
きばく札ついげきの術=Paper Bomb Follow-Up Attack#jyutu_name_005
うずまきナルト二千連弾=Na-Ru-To 2K Uzumaki Barrage
がまドスざん=Toad Blade Cut
コンビへんげ=Combo Transform
らせん丸=Rasengan
きゅうびのチャクラ=Nine-Tailed Fox Spirit Chakra
きゅうきょくらせん丸=Ultimate Rasengan
しゃりんがん=Sharingan
ししれんだん=Lions Barrage
火とん・ごうかきゅうの術=Fire Style: Fire Ball Jutsu
火とん・ほうせんかの術=Fire Style: Phoenix Flower Jutsu
火とん・りゅうかの術=Fire Style: Dragon Flame Jutsu
かげしゅりけんの術=Shadow Shuriken Jutsu#jyutu_name_011
ちどり=Chidori
暗黒ちどり=Dark Chidori#jyutu_name_013
しょうせん術・壱の巻=Heal Jutsu: Level 1
しょうせん術・弐の巻=Heal Jutsu: Level 2
しょうせん術・参の巻=Heal Jutsu: Level 3
しょうせん術・四の巻=Heal Jutsu: Level 4
しょうせんりん術・壱の巻=Heal All Jutsu: Level 1
しょうせんりん術・弐の巻=Heal All Jutsu: Level 2
しょうせんりん術・参の巻=Heal All Jutsu: Level 3
しょうせんりん術・四の巻=Heal All Jutsu: Level 4
ブービートラップ=Booby Trap
うちなるサクラ=Inner Sakura
しゃーんなろーコンボ=Cha! Combo#jyutu_name_016
おおいなるサクラ=Almighty Sakura#jyutu_name_017
サクラふぶきの術=Sakura Blizzard Jutsu#jyutu_name_018
あんちゅうひやくの術=Deceptive Jutsu
かっさつじざいの術=Playing Dead Jutsu#tc 活殺自在の術 jyutu_name_01a
かげまねの術=Shadow Possession Jutsu
かげよみの術=#tc 影黄泉の術 jyutu_name_01c
かげくびしばりの術=Shadow Strangle Jutsu
かげならくの術=Shadow Drop Jutsu
にくだんせんしゃ=Human Boulder
にくだんはりせんしゃ=Spiky Human Boulder#jyutu_name_020
ぶぶんばいかのじゅつ=Partial Expansion Jutsu#jyutu_name_021
ちょうばいかのじゅつ=Super Expansion Jutsu#jyutu_name_022
四きゃくの術=All-Four Jutsu
ダイナミックマーキング=Dynamic Marking#jyutu_name_024
つうが=Tunnelling Fang#jyutu_name_025
がつうが=Fang Over Fang
がろうが=Wolf Fang Over Fang#jyutu_name_026
びゃくがん=Byakugan
てんけつ=Chakra Points
はっけしょうかいてん=8 Trigrams Palms Rotation
はっけ六十四しょう=8 Trigrams 64 Palms
はっけ百二十八しょう=8 Trigrams 128 Palms
木ノ葉れっぷう=Leaf Whirlwind
木ノ葉せんぷう=Leaf Hurricane
木ノ葉だいせんぷう=Leaf’s Severe Hurricane
八門とんこう=The Eight Inner Gates
おもてれんげ=Primary Lotus
うられんげ=Hidden Lotus
さばくそうそう=Sand Burial
すなしぐれ=Sand Shower#jyutu_name_034
りゅうさばくりゅう=Sand Tsunami#jyutu_name_035
さばくたいそう=Giant Sand Burial#jyutu_name_036
しゅかくのたて=Shukaku’s Shield#jyutu_name_037
大カマイタチの術=Cyclone Scythe Jutsu#jyutu_name_038
口よせ・きりきりまい=Summon: Blade Dance#jyutu_name_039
くぐつの術・どくけむり=Poison Smoke Bombs
くぐつしばりの術=Puppet Master Jutsu: Bound
くろひぎききいっぱつ=Secret Black Move Iron Maiden#jyutu_name_03c
口よせ・やたいくずしの術=Summon: Bring Down The House#jyutu_name_03d
にんぽう・はりじぞう=Ninja Art: Needle Jizo#jyutu_name_03e
土とん・よみぬま=Earth Style: Dark Swamp#jyutu_name_03f
火とん・がまゆえんだん=Fire Style: Toad Flame Bombs
ぜったいひとりみパンチ=100% Single Punch#jyutu_name_041
つうてんきゃく=Heaven Kick of Pain#jyutu_name_042
らんしんしょう=Wild Body Strike#jyutu_name_043
口よせ・ぜっしねんさん=Summon: Acid Slime#jyutu_name_44
くさなぎのけん=Snake Sword#jyutu_name_45
口よせ・マンダ=Summon: Manda#jyutu_name_46
さっき=Intention to Kill#jyutu_name_47
せんねんごろし=A Thousand Years of Death
らいきり=Lightning Blade
しのびばな・とりかぶと=Ninja Flower: Wolfsbane#jyutu_name_04a
しのびばな・あきざくら=Ninja Flower: Cosmos
あいのバラいっぽん=A Single Rose of Love#jyutu_name_04c
しんてんしんの術=Mind Transfer Jutsu
きかい蟲・どく=Parasite: Poison
きかい蟲・かなしばり=Parasite: Petrify
きかい蟲・術ふうじ=Parasite: Block Jutsu
きかい蟲・きゅうけつ=Parasite: Blood Suck#jyutu_name_051
じゅうけん=Gentle Fist#jyutu_name_052
はっけそうしょうは=8 Trigrams Sect Palm Wave#jyutu_name_053
ひでんのきずぐすり=Family Secret Ointment#jyutu_name_054
あんき連弾=Hidden Weapon Barrage
そうしょうりゅう=Rising Twin Dragons
武具たいてん=All Weapons Beneath Heaven
分身大ばくは=Shadow Clone Explosion
つくよみ=Tsukuyomi
あまてらす=Amaterasu#jyutu_name_05a
サメハダ=Shark Skin#jyutu_name_05b
水とん・水こう弾の術=Water Style: Water Shark Bomb
土とん・どりょうだんご=Earth Style: Rock Dango Jutsu#Sphere of Graves jyutu_name_05e
にんぽう・クモソウカイ=Ninja Art: Spiral Spider Web
にんぽう・クモねんきん=Ninja Art: Gum Style Spider Thread
クモせんきゅう・スザク=Spider Battle Bow: Super Slice
たれんけん=Multiple Fists Barrage
きせいきかいの術=Parasite Demon Jutsu
口よせ・しのせんりつ=Summon: Melody of Death
まきょうのらん=Demon Revolution
まてき・むげんおんさ=Chains of Fantasia
テシセンダン=Digital Shrapnel
てっせんかのまい=Clematis Dance
さわらびのまい=Bracken Dance
チャクラのメス=Chakra Scalpel
しこんの術=Dead Soul Jutsu
木ノ葉ごうりきせんぷう=Severe Leaf Hurricane#jyutu_name_06c
ひえん=Flying Swallow#jyutu_name_06d
まげん・じゅばくさつ=Evil Illusion: Tree Bind Kill#jyutu_name_06e
全体攻撃=All Attack
にげる=Flee
にとうりゅう=Double Swords
しゅりけん攻撃=Shuriken Attack
オノもうだ=Axe Blow
どく攻撃=Poison Attack
かなしばり攻撃=Petrify Attack
さくらん攻撃=Confusion Attack
みねうち=Back of Sword Blow
ばっとう術=Sword Drawing Jutsu
いあい=Sword Technique
らんぎり=Deranged Slash
ゆうわく=Seduction
かつ！=Hah!
ほうこう=Roar
どくけむり=Poison Smoke
ちょうおんぱ=Super Sonic Wave
じゅおんのいん=Sign of Cursed Anger
あんき=Hidden Weapon
つき=Charge! Charge!
サイレントキリング=Silent Killing
めいそう=Meditation
きゅうけつ=Bloodsucker
！！=!!!
かくごしろ！！=Be ready for me!!!
しんがん=Mind Eye
かえんけん=
すいりゅうけん=
らいめいけん=
さじんけん=
いただきっ！=Gotcha!
くぐつの術=Puppet Jutsu
おとくぐつの術=Sound Puppet Jutsu
まげんくぐつの術=
であえー！=Charge!
口よせ=Summon
みかた攻撃=Attack Ally
じこけんおにおちいる=Filled with self-hate...
ミス攻撃？=Nose Bleed
はなぢブー=Nose Bleed
ムッツリスケベ=Closet Perv
オープンスケベ=Shameless Perv
口よせ・トントン=Summon: Tonton
口よせ・ガマ吉=Summon: Gamakichi
口よせ・ガマ竜=Summon: Gamatatsu
口よせ・カツユ=Summon: Katsuyu
口よせ・パックン=Summon: Pakkun
手裏剣らんぶ=Shuriken Wild Dance
大突風=Wind Style: Great Breach#Orochimaru move, I assume it’s this
水とん・水りゅう弾=Water Style: Water Dragon Bullet
しゅりけんへんげ=Transform Shuriken
火炎しゅりけんらんぶ=Fire Shuriken Dance
メルヘンくずし=Fairy Tale Destruction
かげまね大とっぱ=Shadow Possession Big Break
がつう連弾=
まげん・しゃりんがん=Evil Illusion: Sharingan
かげぬいカマイタチ=Shadow Stitch Wind Scythe#jyutu_name_08c
ドスケベくずし=
うちなるしんてんしん=
モジモジアタック=
そうらいちどり=Double Lightning Chidori
じゅいんぼうそう=#jyutu_name_07a 呪印暴走
必中あんきかいてん=#jyutu_name_08d 必中暗器回天
はっけそうじゅうれっぱ=Trigrams Ripping Wave#jyutu_name_07c
天しょうせんさいかっせい=#jyutu_name_07d 天掌仙再活性
さじんごうせんぷう=Severe Sand Hurricane#jyutu_name_07e
はっけごうれっぷう=#jyutu_name_07f
かげまねおんど=
がちゅうせん=Fang Insect Pierce
Ｗイチャパラ=
にせんねんごろし=Two Thousand Years of Death
木ノ葉かげらんぶ=Hidden Leaf Hidden Wild Dance
うずまき大せんぷう=
かげうつしの術=Shadow Imprint Jutsu
うつくしきあおいやじゅう=
まげん・ちりざくらの術=Evil Illusion: Scattered Cherry Jutsu
砂くぐつの術=Sand Puppet Jutsu
しのびＩＱのけい=Calculate Ninja IQ#jyutu_name_08a
らせんちどり=Rasen-Chidori#jyutu_name_07b
していらせん丸=Master-Pupil-Rasen-Round#jyutu_name_08e
しんてんしん攻撃=
デモ　ごうかきゅう=
デモ　ちきゅうわり=
デモ　チャクラのメス=
デモ　かげ分身ばくは=
デモ　たれんけん=
ひょうい攻撃=
