ダミー=
ヘビ=Snake
どくヘビ=Poisonous Snake
じゃえい=
コウモリ=Bat
ちすいコウモリ=Blood-sucking Bat
しのびコウモリ=Ninja Bat
ヒル=Leech
ちすいヒル=Blood-sucking Leech
ムカデ=Centipede
どくムカデ=Poisonous Centipede
くさりムカデ=Chain Centipede
やけん=
ぐんけん=
にんけん=
ようじんぼう=
サムライ=Samurai
ひけんたい=
さんぞく=Bandit
さんぞくがしら=Head Bandit
とうぞく=
ざこにん=Nobody Ninja
しかく=
おんみつ=
おとにん=Sound Ninja
まげんおとにん=
ごうにん=
まげんごうにん=
くさにん=Grass Ninja
あめにん=Rain Ninja
くぐつ=Puppet
おとくぐつ=Sound Puppet
まげんくぐつ=
げんじゅつたい=
まげんくノいち=
むげんくノいち=
あんぶ=Anbu
サスケ=Sasuke
ツナデ=Tsunade
カブト=Kabuto
オロチまる=Orochimaru
キサメ=Kisame
イタチ=Itachi
ジロウボウ=Jirobo
キドウマル=Kidomaru
タユヤ=Tayuya
サコン=Sakon
ウコン=
キミマロ=Kimimaro
アニキ=
おやぶん=
ガマこぞう=Toad Boy
いわガマこぞう=Rock Toad Boy
きりにん=Mist Ninja
こしぎんちゃく=Henchman
ボディーガード=Bodyguard
あらくれもの=Hungry One
おいはぎ=
ワガラシいっか=
くノいち=
こういってん=
とら=Tiger
びゃっこ=White Tiger
にんこ=Ninja Tiger
クモ=Spider
じょろうグモ=Silk Spider
しのびグモ=Ninja Spider
ろうにん=
はくろう=White Wolf
くさのほりょにん=
あめのほりょにん=
きりのほりょにん=
いの=Ino
シカマル=Shikamaru
チョウジ=Choji
キバ=Kiba
シノ=Shino
ヒナタ=Hinata
ネジ=Neji
リー=Lee
テンテン=Tenten
ナルト=Naruto
カカシ=Kakashi
アスマ=Asuma
くれない=Kurenai
サクラ=Sakura
じらいや=Jiraiya
ガイ=Guy
ガアラ=Gaara
テマリ=Temari
カンクロウ=Kankuro
